~~~~~~~~~~~~~~~~~~~~~~~~~
~~~~~~~~~~~~~~~~~~~~~~~~~
~~~~X~~~~~~~~~~~~~~~~~~~~
~~~~X~~~~~~~*~~~~~~~~~~~~
~~~~XXXXXX~~~~~~~~~~~~~~~
~~~~~~~~C~~~~~~~~~~~~~~~~
~~~~~~~~~~~~~~~~~~~~~~~~~
~~~*~~~~C~~R~~~~~~~~~~~~~
~PP~~~~~~~~~~~~~~~~~~~~~~
~~~~~P~~~~~~~~~~~R~~~~~~~
~~RC~~~~~~~~~~~~~~~~~~~~~
~~C~~~~~~~~~~~~~~~~~~~~~~
~~~~~~~~C~~~~~~~P~~~~~~~~
~~~~~P~~~~~~~~~~~~~~~~~~~
~~~~~~~~~~~~~~~~~~~~~~~~~
